5 20
|--------|
|...|..-.|
|..-|.@..|
|......-.|
|--------|